~~~ Level 1 ~~~
16x16, 15.15, 2.3
0000000000000000
0001000000000000
0000100000000000
0011100000000000
0000000000000000
0000000000000000
0000000000000000
0000000000000000
0000000000010000
0000000000000000
0000000000000000
0000000000000000
0000000000000000
0110001100000000
0110001100000000
0000000000000000
